#####################################################
#. . . . . . . . . . . .#####. . . . . . . . . . . .#
#.#########.###########.#####.###########.#########.#
#.#########.###########.#####.###########.#########.#
#. . . . . . . . . . . . . . . . . . . . . . . . . .#
#.#########.#####.#################.#####.#########.#
#. . . . . .#####. . . . ### . . . .#####. . . . . .#
#######.###.############ ### ############.###.#######
#######.###.####                     ####.###.#######
#######.###.#### ######## # ######## ####.###.#######
#######.###.#### ######## # ######## ####.###.#######
#######. . .           &#&#&#&           . . .#######
#######.###.#### ################### ####.###.#######
#######.###.####          @          ####.###.#######
#######.###.#### ################### ####.###.#######
#. . . . . . . . . . . .#####. . . . . . . . . . . .#
#.#########.###########.#####.###########.#########.#
#. . .#####. . . . . . .  . . . . . . .. .#####. . .#
#####.#####.#####.#################.#####.#####.#####
#. . . . . .#####. . . .#####. . . .#####. . . . . .#
#.#####################.#####.#####################.#
#. . . . . . . . . . . . . . . . . . . . . . . . . .#
#####################################################